#query	genus	phylum	domain
Acholeplasma oculi	Acholeplasma	Mycoplasmatota	Bacteria
Acinetobacter	Acinetobacter	Pseudomonadota	Bacteria
Acinetobacter baumannii	Acinetobacter	Pseudomonadota	Bacteria
Acinetobacter baylyi	Acinetobacter	Pseudomonadota	Bacteria
Acinetobacter beijerinckii	Acinetobacter	Pseudomonadota	Bacteria
Acinetobacter bereziniae	Acinetobacter	Pseudomonadota	Bacteria
Acinetobacter calcoaceticus	Acinetobacter	Pseudomonadota	Bacteria
Acinetobacter haemolyticus	Acinetobacter	Pseudomonadota	Bacteria
Acinetobacter johnsonii	Acinetobacter	Pseudomonadota	Bacteria
Acinetobacter junii	Acinetobacter	Pseudomonadota	Bacteria
Acinetobacter lwoffii	Acinetobacter	Pseudomonadota	Bacteria
Acinetobacter parvus	Acinetobacter	Pseudomonadota	Bacteria
Acinetobacter ursingii	Acinetobacter	Pseudomonadota	Bacteria
Actinobacillus capsulatus	Actinobacillus	Pseudomonadota	Bacteria
Actinomyces bowdenii	Actinomyces	Actinomycetota	Bacteria
Actinomyces bowdenii	Actinomyces	Actinomycetota	Bacteria
Actinomyces canis	Schaalia	Actinomycetota	Bacteria
Actinomyces catuli	Actinomyces	Actinomycetota	Bacteria
Actinomyces coleocanis	Gleimia	Actinomycetota	Bacteria
Actinomyces hordeovulneris	Buchananella	Actinomycetota	Bacteria
Actinomyces hyovaginalis	Schaalia	Actinomycetota	Bacteria
Actinomyces meyeri	Schaalia	Actinomycetota	Bacteria
Actinomyces odontolyticus	Schaalia	Actinomycetota	Bacteria
Actinomyces pyogenes	Trueperella	Actinomycetota	Bacteria
Actinomyces turicensis			
Actinomyces viscous			
Aeromonas	Aeromonas	Pseudomonadota	Bacteria
Aeromonas hydrophila	Aeromonas	Pseudomonadota	Bacteria
Aeromonas salmonicida	Aeromonas	Pseudomonadota	Bacteria
Aggregatibacter actinomycetemcomitans	Aggregatibacter	Pseudomonadota	Bacteria
Alcaligenes	Alcaligenes	Pseudomonadota	Bacteria
Alcaligenes faecalis	Alcaligenes	Pseudomonadota	Bacteria
Aliivibrio salmonicida	Aliivibrio	Pseudomonadota	Bacteria
Anaerobiospirillum	Anaerobiospirillum	Pseudomonadota	Bacteria
Anaerococcus prevotii	Anaerococcus	Bacillota	Bacteria
Anaerococcus vaginalis	Anaerococcus	Bacillota	Bacteria
Anaplasma	Anaplasma	Pseudomonadota	Bacteria
Anaplasma phagocytophilum	Anaplasma	Pseudomonadota	Bacteria
Anaplasma platys	Anaplasma	Pseudomonadota	Bacteria
Arcanobacterium canis	Arcanobacterium	Actinomycetota	Bacteria
Arcanobacterium phocae	Arcanobacterium	Actinomycetota	Bacteria
Arcanobacterium pyogenes	Trueperella	Actinomycetota	Bacteria
Arcobacter	Arcobacter	Campylobacterota	Bacteria
Austwickia chelonae	Austwickia	Actinomycetota	Bacteria
Avibacterium paragallinarum	Avibacterium	Pseudomonadota	Bacteria
Bacteroides denticanum	Bacteroides	Bacteroidota	Bacteria
Bacteroides fragilis	Bacteroides	Bacteroidota	Bacteria
Bacteroides heparinolyticus	Bacteroides	Bacteroidota	Bacteria
Bacteroides pyogenes	Bacteroides	Bacteroidota	Bacteria
Bacteroides uniformis	Bacteroides	Bacteroidota	Bacteria
Bartonella	Bartonella	Pseudomonadota	Bacteria
Bartonella bacilliformis	Bartonella	Pseudomonadota	Bacteria
Bartonella clarridgeiae	Bartonella	Pseudomonadota	Bacteria
Bartonella elizabethae	Bartonella	Pseudomonadota	Bacteria
Bartonella grahamii	Bartonella	Pseudomonadota	Bacteria
Bartonella henselae	Bartonella	Pseudomonadota	Bacteria
Bartonella koehlerae	Bartonella	Pseudomonadota	Bacteria
Bartonella naantaliensis	Bartonella	Pseudomonadota	Bacteria
Bartonella quintana	Bartonella	Pseudomonadota	Bacteria
Bartonella rochalimae	Bartonella	Pseudomonadota	Bacteria
Bartonella vinsonii	Bartonella	Pseudomonadota	Bacteria
Basilea psittacipulmonis	Basilea	Pseudomonadota	Bacteria
Bergeyella zoohelcum	Bergeyella	Bacteroidota	Bacteria
Bibersteinia trehalosi	Bibersteinia	Pseudomonadota	Bacteria
Bordetella	Bordetella	Pseudomonadota	Bacteria
Bordetella avium	Bordetella	Pseudomonadota	Bacteria
Bordetella bronchiseptica	Bordetella	Pseudomonadota	Bacteria
Bordetella parapertussis	Bordetella	Pseudomonadota	Bacteria
Bordetella pertussis	Bordetella	Pseudomonadota	Bacteria
Borrelia afzelii	Borreliella	Spirochaetota	Bacteria
Borrelia anserina	Borrelia	Spirochaetota	Bacteria
Borrelia burgdorferi	Borreliella	Spirochaetota	Bacteria
Borrelia crocidurae	Borrelia	Spirochaetota	Bacteria
Borrelia duttonii	Borrelia	Spirochaetota	Bacteria
Borrelia garinii	Borreliella	Spirochaetota	Bacteria
Borrelia hermsii	Borrelia	Spirochaetota	Bacteria
Borrelia hispanica	Borrelia	Spirochaetota	Bacteria
Borrelia mayonii	Borreliella	Spirochaetota	Bacteria
Borrelia miyamotoi	Borrelia	Spirochaetota	Bacteria
Borrelia parkeri	Borrelia	Spirochaetota	Bacteria
Borrelia persica	Borrelia	Spirochaetota	Bacteria
Borrelia recurrentis	Borrelia	Spirochaetota	Bacteria
Borrelia turicatae	Borrelia	Spirochaetota	Bacteria
Borreliella afzelli			
Borreliella burgdorferi	Borreliella	Spirochaetota	Bacteria
Borreliella garinii	Borreliella	Spirochaetota	Bacteria
Brachyspira	Brachyspira	Spirochaetota	Bacteria
Brachyspira hyodysenteriae	Brachyspira	Spirochaetota	Bacteria
Brachyspira pilosicoli	Brachyspira	Spirochaetota	Bacteria
Brevibacterium casei	Brevibacterium	Actinomycetota	Bacteria
Brevibacterium luteolum	Brevibacterium	Actinomycetota	Bacteria
Brucella	Brucella	Pseudomonadota	Bacteria
Brucella abortus	Brucella	Pseudomonadota	Bacteria
Brucella canis	Brucella	Pseudomonadota	Bacteria
Brucella melitensis	Brucella	Pseudomonadota	Bacteria
Brucella suis	Brucella	Pseudomonadota	Bacteria
Burkholderia	Burkholderia	Pseudomonadota	Bacteria
Burkholderia ambifaria	Burkholderia	Pseudomonadota	Bacteria
Burkholderia anthina	Burkholderia	Pseudomonadota	Bacteria
Burkholderia cenocepacia	Burkholderia	Pseudomonadota	Bacteria
Burkholderia cepacia	Burkholderia	Pseudomonadota	Bacteria
Burkholderia contaminans	Burkholderia	Pseudomonadota	Bacteria
Burkholderia gladioli	Burkholderia	Pseudomonadota	Bacteria
Burkholderia glumae	Burkholderia	Pseudomonadota	Bacteria
Burkholderia mallei	Burkholderia	Pseudomonadota	Bacteria
Burkholderia multivorans	Burkholderia	Pseudomonadota	Bacteria
Burkholderia pseudomallei	Burkholderia	Pseudomonadota	Bacteria
Burkholderia pyrrocinia	Burkholderia	Pseudomonadota	Bacteria
Burkholderia stabilis	Burkholderia	Pseudomonadota	Bacteria
Campylobacter	Campylobacter	Campylobacterota	Bacteria
Campylobacter avium	Campylobacter	Campylobacterota	Bacteria
Campylobacter concisus	Campylobacter	Campylobacterota	Bacteria
Campylobacter fetus	Campylobacter	Campylobacterota	Bacteria
Campylobacter gracilis	Campylobacter	Campylobacterota	Bacteria
Campylobacter jejuni	Campylobacter	Campylobacterota	Bacteria
Campylobacter lari	Campylobacter	Campylobacterota	Bacteria
Campylobacter rectus	Campylobacter	Campylobacterota	Bacteria
Campylobacter upsaliensis	Campylobacter	Campylobacterota	Bacteria
Campylobacter ureolyticus	Campylobacter	Campylobacterota	Bacteria
Capnocytophaga cynodegmi	Capnocytophaga	Bacteroidota	Bacteria
Caviibacter abscessus	Caviibacter	Fusobacteriota	Bacteria
Chelonobacter oris	Chelonobacter	Pseudomonadota	Bacteria
Chlamydia	Chlamydia	Chlamydiota	Bacteria
Chlamydia abortus	Chlamydia	Chlamydiota	Bacteria
Chlamydia avium	Chlamydia	Chlamydiota	Bacteria
Chlamydia caviae	Chlamydia	Chlamydiota	Bacteria
Chlamydia felis	Chlamydia	Chlamydiota	Bacteria
Chlamydia gallinacea	Chlamydia	Chlamydiota	Bacteria
Chlamydia pecorum	Chlamydia	Chlamydiota	Bacteria
Chlamydia pneumoniae	Chlamydia	Chlamydiota	Bacteria
Chlamydia psittaci	Chlamydia	Chlamydiota	Bacteria
Chlamydia suis	Chlamydia	Chlamydiota	Bacteria
Chlamydia trachomatis	Chlamydia	Chlamydiota	Bacteria
Chlamydophila psittaci	Chlamydia	Chlamydiota	Bacteria
Chryseobacterium indologenes	Chryseobacterium	Bacteroidota	Bacteria
Citrobacter	Citrobacter	Pseudomonadota	Bacteria
Citrobacter freundii	Citrobacter	Pseudomonadota	Bacteria
Clostridioides difficile	Clostridioides	Bacillota	Bacteria
Clostridium	Clostridium	Bacillota	Bacteria
Clostridium botulinum	Clostridium	Bacillota	Bacteria
Clostridium butyricum	Clostridium	Bacillota	Bacteria
Clostridium chauvoei	Clostridium	Bacillota	Bacteria
Clostridium difficile			
Clostridium disporicum	Clostridium	Bacillota	Bacteria
Clostridium paraputrificum	Clostridium	Bacillota	Bacteria
Clostridium perfringens	Clostridium	Bacillota	Bacteria
Clostridium piliforme	Tyzzerella	Bacillota	Bacteria
Clostridium septicum	Clostridium	Bacillota	Bacteria
Clostridium spiroforme	Thomasclavelia	Bacillota	Bacteria
Clostridium sporogenes	Clostridium	Bacillota	Bacteria
Clostridium tetani	Clostridium	Bacillota	Bacteria
Corynebacterium amycolatum	Corynebacterium	Actinomycetota	Bacteria
Corynebacterium aurimucosum	Corynebacterium	Actinomycetota	Bacteria
Corynebacterium auriscanis	Corynebacterium	Actinomycetota	Bacteria
Corynebacterium freneyi	Corynebacterium	Actinomycetota	Bacteria
Corynebacterium jeikeium	Corynebacterium	Actinomycetota	Bacteria
Corynebacterium kroppenstedtii	Corynebacterium	Actinomycetota	Bacteria
Corynebacterium kutscheri	Corynebacterium	Actinomycetota	Bacteria
Corynebacterium lactis	Corynebacterium	Actinomycetota	Bacteria
Corynebacterium mastitidis	Corynebacterium	Actinomycetota	Bacteria
Corynebacterium pseudogenitalium	Corynebacterium	Actinomycetota	Bacteria
Corynebacterium pseudotuberculosis	Corynebacterium	Actinomycetota	Bacteria
Corynebacterium renale	Corynebacterium	Actinomycetota	Bacteria
Corynebacterium stationis	Corynebacterium	Actinomycetota	Bacteria
Corynebacterium tuberculostearicum	Corynebacterium	Actinomycetota	Bacteria
Corynebacterium ulcerans	Corynebacterium	Actinomycetota	Bacteria
Corynebacterium urealyticum	Corynebacterium	Actinomycetota	Bacteria
Corynebacterium urealyticum	Corynebacterium	Actinomycetota	Bacteria
Corynebacterium xerosis	Corynebacterium	Actinomycetota	Bacteria
Cronobacter	Cronobacter	Pseudomonadota	Bacteria
Defluviitalea phaphyphila	Defluviitalea	Bacillota	Bacteria
Defluviitalea raffinosedens	Defluviitalea	Bacillota	Bacteria
Defluviitalea saccharophila	Defluviitalea	Bacillota	Bacteria
Dermatophilus	Dermatophilus	Actinomycetota	Bacteria
Desulfovibrio	Desulfovibrio	Thermodesulfobacteriota	Bacteria
Devriesea agamarum	Devriesea	Actinomycetota	Bacteria
Ehrlichia	Ehrlichia	Pseudomonadota	Bacteria
Ehrlichia canis	Ehrlichia	Pseudomonadota	Bacteria
Ehrlichia chaffeensis	Ehrlichia	Pseudomonadota	Bacteria
Ehrlichia ewingii	Ehrlichia	Pseudomonadota	Bacteria
Ehrlichia ruminantium	Ehrlichia	Pseudomonadota	Bacteria
Enterobacter	Enterobacter	Pseudomonadota	Bacteria
Enterobacter cloacae	Enterobacter	Pseudomonadota	Bacteria
Enterococcus	Enterococcus	Bacillota	Bacteria
Enterococcus faecalis	Enterococcus	Bacillota	Bacteria
Enterococcus faecium	Enterococcus	Bacillota	Bacteria
Erysipelothrix	Erysipelothrix	Bacillota	Bacteria
Erysipelothrix rhusiopathiae	Erysipelothrix	Bacillota	Bacteria
Escherichia	Escherichia	Pseudomonadota	Bacteria
Escherichia coli	Escherichia	Pseudomonadota	Bacteria
Fibrobacter succinogenes	Fibrobacter	Fibrobacterota	Bacteria
Filobacterium rodentium	Filobacterium	Bacteroidota	Bacteria
Finegoldia magna	Finegoldia	Bacillota	Bacteria
Flavobacterium columnare	Flavobacterium	Bacteroidota	Bacteria
Flavobacterium terrae	Flavobacterium	Bacteroidota	Bacteria
Francisella	Francisella	Pseudomonadota	Bacteria
Francisella tularensis	Francisella	Pseudomonadota	Bacteria
Fusobacterium	Fusobacterium	Fusobacteriota	Bacteria
Fusobacterium canifelinum	Fusobacterium	Fusobacteriota	Bacteria
Fusobacterium nucleatum	Fusobacterium	Fusobacteriota	Bacteria
Fusobacterium russii	Fusobacterium	Fusobacteriota	Bacteria
Glaesserella parasuis	Glaesserella	Pseudomonadota	Bacteria
Globicatella sanguinis	Globicatella	Bacillota	Bacteria
Granulicatella adiacens	Granulicatella	Bacillota	Bacteria
Haemophilus ducreyi	Haemophilus	Pseudomonadota	Bacteria
Haemophilus influenzae	Haemophilus	Pseudomonadota	Bacteria
Hafnia paralvei	Hafnia	Pseudomonadota	Bacteria
Helcococcus kunzii	Helcococcus	Bacillota	Bacteria
Helicobacter	Helicobacter	Campylobacterota	Bacteria
Helicobacter cinaedi	Helicobacter	Campylobacterota	Bacteria
Helicobacter mustelae	Helicobacter	Campylobacterota	Bacteria
Helicobacter pylori	Helicobacter	Campylobacterota	Bacteria
Haemophilus	Haemophilus	Pseudomonadota	Bacteria
Haemophilus gallinarum	Avibacterium	Pseudomonadota	Bacteria
Klebsiella	Klebsiella	Pseudomonadota	Bacteria
Klebsiella aerogenes	Klebsiella	Pseudomonadota	Bacteria
Klebsiella oxytoca	Klebsiella	Pseudomonadota	Bacteria
Klebsiella pneumoniae	Klebsiella	Pseudomonadota	Bacteria
Kocuria kristinae	Rothia	Actinomycetota	Bacteria
Kocuria marina	Kocuria	Actinomycetota	Bacteria
Lactococcus	Lactococcus	Bacillota	Bacteria
Lawsonella clevelandensis	Lawsonella	Actinomycetota	Bacteria
Leclercia	Leclercia	Pseudomonadota	Bacteria
Leclercia adecarboxylata	Leclercia	Pseudomonadota	Bacteria
Legionella	Legionella	Pseudomonadota	Bacteria
Legionella pneumophila	Legionella	Pseudomonadota	Bacteria
Leptospira	Leptospira	Spirochaetota	Bacteria
Leptospira borgpetersenii	Leptospira	Spirochaetota	Bacteria
Leptospira fainei	Leptospira	Spirochaetota	Bacteria
Leptospira inadai	Leptospira	Spirochaetota	Bacteria
Leptospira interrogans	Leptospira	Spirochaetota	Bacteria
Leptospira kirschneri	Leptospira	Spirochaetota	Bacteria
Leptospira noguchii	Leptospira	Spirochaetota	Bacteria
Leptospira santarosai	Leptospira	Spirochaetota	Bacteria
Leptospira weilii	Leptospira	Spirochaetota	Bacteria
Leuconostoc carnosum	Leuconostoc	Bacillota	Bacteria
Leuconostoc citreum	Leuconostoc	Bacillota	Bacteria
Leuconostoc fallax	Leuconostoc	Bacillota	Bacteria
Leuconostoc garlicum	Leuconostoc	Bacillota	Bacteria
Leuconostoc gelidum	Leuconostoc	Bacillota	Bacteria
Leuconostoc holzapfelii	Leuconostoc	Bacillota	Bacteria
Leuconostoc inhae	Leuconostoc	Bacillota	Bacteria
Leuconostoc kimchii	Leuconostoc	Bacillota	Bacteria
Leuconostoc mesenteroides	Leuconostoc	Bacillota	Bacteria
Leuconostoc miyukkimchii	Leuconostoc	Bacillota	Bacteria
Leuconostoc palmae	Leuconostoc	Bacillota	Bacteria
Leuconostoc pseudomesenteroides	Leuconostoc	Bacillota	Bacteria
Leuconostoc rapi	Leuconostoc	Bacillota	Bacteria
Leuconostoc suionicum	Leuconostoc	Bacillota	Bacteria
Listeria	Listeria	Bacillota	Bacteria
Listeria monocytogenes	Listeria	Bacillota	Bacteria
Listonella	Vibrio	Pseudomonadota	Bacteria
Mannheimia granulomatis	Mannheimia	Pseudomonadota	Bacteria
Melissococcus plutonius	Melissococcus	Bacillota	Bacteria
Micrococcus	Micrococcus	Actinomycetota	Bacteria
Micrococcus luteus	Micrococcus	Actinomycetota	Bacteria
Moraxella catarrhalis	Moraxella	Pseudomonadota	Bacteria
Moraxella cuniculi	Moraxella	Pseudomonadota	Bacteria
Moraxella porci	Moraxella	Pseudomonadota	Bacteria
Mycobacterium	Mycobacterium	Actinomycetota	Bacteria
Mycobacterium avium	Mycobacterium	Actinomycetota	Bacteria
Mycobacterium avium subsp. Columbae			
Mycobacterium bovis			
Mycobacterium chelonea			
Mycobacterium fortuitum	Mycolicibacterium	Actinomycetota	Bacteria
Mycobacterium haemophilum	Mycobacterium	Actinomycetota	Bacteria
Mycobacterium leprae	Mycobacterium	Actinomycetota	Bacteria
Mycobacterium liflandii	Mycobacterium	Actinomycetota	Bacteria
Mycobacterium malmoense	Mycobacterium	Actinomycetota	Bacteria
Mycobacterium marinum	Mycobacterium	Actinomycetota	Bacteria
Mycobacterium microti			
Mycobacterium pseudoshottii			
Mycobacterium shottii			
Mycobacterium szulgai	Mycobacterium	Actinomycetota	Bacteria
Mycobacterium tuberculosis	Mycobacterium	Actinomycetota	Bacteria
Mycobacterium ulcerans	Mycobacterium	Actinomycetota	Bacteria
Mycobacterium xenopi	Mycobacterium	Actinomycetota	Bacteria
Mycobacteroides	Mycobacteroides	Actinomycetota	Bacteria
Mycobacteroides abscessus	Mycobacteroides	Actinomycetota	Bacteria
Mycobacteroides chelonae	Mycobacteroides	Actinomycetota	Bacteria
Mycolicibacterium aubagnense	Mycolicibacterium	Actinomycetota	Bacteria
Mycolicibacterium doricum	Mycolicibacterium	Actinomycetota	Bacteria
Mycolicibacterium fortuitum	Mycolicibacterium	Actinomycetota	Bacteria
Mycolicibacterium goodii	Mycolicibacterium	Actinomycetota	Bacteria
Mycolicibacterium peregrinum	Mycolicibacterium	Actinomycetota	Bacteria
Mycolicibacterium phlei	Mycolicibacterium	Actinomycetota	Bacteria
Mycolicibacterium porcinum	Mycolicibacterium	Actinomycetota	Bacteria
Mycolicibacterium smegmatis	Mycolicibacterium	Actinomycetota	Bacteria
Mycolicibacterium thermoresistibile	Mycolicibacterium	Actinomycetota	Bacteria
Mycolicibacterium wolinskyi	Mycolicibacterium	Actinomycetota	Bacteria
Mycoplasma pulmonis			
Mycoplasma	Mycoplasma	Mycoplasmatota	Bacteria
Mycoplasma agassizii	Mycoplasmopsis	Mycoplasmatota	Bacteria
Mycoplasma arginini	Mycoplasmopsis	Mycoplasmatota	Bacteria
Mycoplasma bovigenitalium	Mycoplasmopsis	Mycoplasmatota	Bacteria
Mycoplasma canis			
Mycoplasma columbinum			
Mycoplasma cynos			
Mycoplasma edwardii	Mycoplasmopsis	Mycoplasmatota	Bacteria
Mycoplasma feliminutum	Mycoplasma	Mycoplasmatota	Bacteria
Mycoplasma felis			
Mycoplasma gallisepticum	Mycoplasmoides	Mycoplasmatota	Bacteria
Mycoplasma genitalium	Mycoplasmoides	Mycoplasmatota	Bacteria
Mycoplasma haemocanis	Mycoplasma	Mycoplasmatota	Bacteria
Mycoplasma haemofelis	Mycoplasma	Mycoplasmatota	Bacteria
Mycoplasma hominis			
Mycoplasma maculosum			
Mycoplasma molare			
Mycoplasma opalescens			
Mycoplasma pneumoniae			
Mycoplasma spumans			
Mycoplasma synoviae	Mycoplasmopsis	Mycoplasmatota	Bacteria
Neisseria	Neisseria	Pseudomonadota	Bacteria
Neisseria flavescens	Neisseria	Pseudomonadota	Bacteria
Neisseria gonorrhoeae	Neisseria	Pseudomonadota	Bacteria
Neisseria meningitidis	Neisseria	Pseudomonadota	Bacteria
Neisseria mucosa	Neisseria	Pseudomonadota	Bacteria
Neisseria shayeganii	Neisseria	Pseudomonadota	Bacteria
Neorickettsia helminthoeca	Neorickettsia	Pseudomonadota	Bacteria
Neorickettsia risticii	Neorickettsia	Pseudomonadota	Bacteria
Nicoletella	Nicoletella	Pseudomonadota	Bacteria
Nocardia	Nocardia	Actinomycetota	Bacteria
Nocardia abscessus	Nocardia	Actinomycetota	Bacteria
Nocardia brasiliensis	Nocardia	Actinomycetota	Bacteria
Nocardia cyriacigeorgicca			
Nocardia farcinica	Nocardia	Actinomycetota	Bacteria
Nocardia nova	Nocardia	Actinomycetota	Bacteria
Nocardia otitidiscaviarum	Nocardia	Actinomycetota	Bacteria
Ochrobactrum	Ochrobactrum	Pseudomonadota	Bacteria
Orientia	Orientia	Pseudomonadota	Bacteria
Paenibacillus larvae	Paenibacillus	Bacillota	Bacteria
Pantoea	Pantoea	Pseudomonadota	Bacteria
Pantoea alhagi	Pantoea	Pseudomonadota	Bacteria
Pantoea allii	Pantoea	Pseudomonadota	Bacteria
Pantoea ananatis	Pantoea	Pseudomonadota	Bacteria
Pantoea anthophila	Pantoea	Pseudomonadota	Bacteria
Pantoea beijingensis	Erwinia	Pseudomonadota	Bacteria
Pantoea brenneri	Pantoea	Pseudomonadota	Bacteria
Pantoea coffeiphila	Pantoea	Pseudomonadota	Bacteria
Pantoea conspicua	Pantoea	Pseudomonadota	Bacteria
Pantoea cypripedii	Pantoea	Pseudomonadota	Bacteria
Pantoea deleyi	Pantoea	Pseudomonadota	Bacteria
Pantoea endophytica	Pantoea	Pseudomonadota	Bacteria
Pantoea eucalypti	Pantoea	Pseudomonadota	Bacteria
Pantoea eucrina	Pantoea	Pseudomonadota	Bacteria
Pantoea latae	Pantoea	Pseudomonadota	Bacteria
Pantoea pleuroti	Pantoea	Pseudomonadota	Bacteria
Pantoea rodasii	Pantoea	Pseudomonadota	Bacteria
Pantoea rwandensis	Pantoea	Pseudomonadota	Bacteria
Pantoea septica	Pantoea	Pseudomonadota	Bacteria
Pantoea sesami	Pantoea	Pseudomonadota	Bacteria
Pantoea stewartii	Pantoea	Pseudomonadota	Bacteria
Pantoea vagans	Pantoea	Pseudomonadota	Bacteria
Pantoea wallisii	Pantoea	Pseudomonadota	Bacteria
Parvimonas micra	Parvimonas	Bacillota	Bacteria
Pasteurella	Pasteurella	Pseudomonadota	Bacteria
Pasteurella canis	Pasteurella	Pseudomonadota	Bacteria
Pasteurella dagmatis	Pasteurella	Pseudomonadota	Bacteria
Pasteurella multocida	Pasteurella	Pseudomonadota	Bacteria
Pelistega europaea	Pelistega	Pseudomonadota	Bacteria
Peptoclostridium	Peptoclostridium	Bacillota	Bacteria
Peptoclostridium acidaminophilum	Peptoclostridium	Bacillota	Bacteria
Peptoclostridium litorale	Peptoclostridium	Bacillota	Bacteria
Peptoniphilus grossensis	Peptoniphilus	Bacillota	Bacteria
Peptoniphilus harei	Peptoniphilus	Bacillota	Bacteria
Peptostreptococcus	Peptostreptococcus	Bacillota	Bacteria
Peptostreptococcus canis	Peptostreptococcus	Bacillota	Bacteria
Photobacterium	Photobacterium	Pseudomonadota	Bacteria
Phyllobacterium myrsinacearum	Phyllobacterium	Pseudomonadota	Bacteria
Phytobacter ursingii	Phytobacter	Pseudomonadota	Bacteria
Plesiomonas shigelloides	Plesiomonas	Pseudomonadota	Bacteria
Porphyromonas cangingivalis	Porphyromonas	Bacteroidota	Bacteria
Porphyromonas circumdentaria	Porphyromonas	Bacteroidota	Bacteria
Porphyromonas gulae	Porphyromonas	Bacteroidota	Bacteria
Prevotella bivia	Prevotella	Bacteroidota	Bacteria
Prevotella buccalis	Hoylesella	Bacteroidota	Bacteria
Prevotella intermedia	Prevotella	Bacteroidota	Bacteria
Prevotella loescheii	Hoylesella	Bacteroidota	Bacteria
Prevotella melaninogenica	Prevotella	Bacteroidota	Bacteria
Prevotella nigrescens	Prevotella	Bacteroidota	Bacteria
Prevotella timonensis			
Providencia	Providencia	Pseudomonadota	Bacteria
Providencia rettgeri	Providencia	Pseudomonadota	Bacteria
Providencia stuartii	Providencia	Pseudomonadota	Bacteria
Pseudomonas aeruginosa	Pseudomonas	Pseudomonadota	Bacteria
Pseudomonas hunanensis	Pseudomonas	Pseudomonadota	Bacteria
Pseudomonas mendocina	Ectopseudomonas	Pseudomonadota	Bacteria
Pseudomonas oryzihabitans	Pseudomonas	Pseudomonadota	Bacteria
Pseudomonas plecoglossicida	Pseudomonas	Pseudomonadota	Bacteria
Pseudomonas putida	Pseudomonas	Pseudomonadota	Bacteria
Pseudopropionibacterium propionicum	Arachnia	Actinomycetota	Bacteria
Ralstonia picketti			
Rickettsia	Rickettsia	Pseudomonadota	Bacteria
Rickettsia africae	Rickettsia	Pseudomonadota	Bacteria
Rickettsia conorii	Rickettsia	Pseudomonadota	Bacteria
Rickettsia conorii sp. Conorii			
Rickettsia helvetica	Rickettsia	Pseudomonadota	Bacteria
Rickettsia sibirica	Rickettsia	Pseudomonadota	Bacteria
Rickettsia slovaca	Rickettsia	Pseudomonadota	Bacteria
Riemerella anatipestifer	Riemerella	Bacteroidota	Bacteria
Roseomonas	Roseomonas	Pseudomonadota	Bacteria
Roseomonas gilardii	Roseomonas	Pseudomonadota	Bacteria
Roseomonas mucosa	Roseomonas	Pseudomonadota	Bacteria
Ruminococcus albus	Ruminococcus	Bacillota	Bacteria
Ruminococcus bicirculans			
Ruminococcus bromii	Ruminococcus	Bacillota	Bacteria
Ruminococcus callidus	Ruminococcus	Bacillota	Bacteria
Ruminococcus champanellensis	Ruminococcus	Bacillota	Bacteria
Ruminococcus faecis	Mediterraneibacter	Bacillota	Bacteria
Ruminococcus flavefaciens	Ruminococcus	Bacillota	Bacteria
Ruminococcus gauvreauii	Ruminococcus	Bacillota	Bacteria
Ruminococcus lactaris	Mediterraneibacter	Bacillota	Bacteria
Salmonella	Salmonella	Pseudomonadota	Bacteria
Salmonella bongori	Salmonella	Pseudomonadota	Bacteria
Salmonella enterica	Salmonella	Pseudomonadota	Bacteria
Salmonella pullorum			
Salmonella typhimurium			
Schaalia canis	Schaalia	Actinomycetota	Bacteria
Shigella	Shigella	Pseudomonadota	Bacteria
Sphingomonas paucimobilis	Sphingomonas	Pseudomonadota	Bacteria
Staphylococcus	Staphylococcus	Bacillota	Bacteria
Staphylococcus aureus	Staphylococcus	Bacillota	Bacteria
Staphylococcus caprae	Staphylococcus	Bacillota	Bacteria
Staphylococcus epidermidis	Staphylococcus	Bacillota	Bacteria
Staphylococcus equorum	Staphylococcus	Bacillota	Bacteria
Staphylococcus felis	Staphylococcus	Bacillota	Bacteria
Staphylococcus haemolyticus	Staphylococcus	Bacillota	Bacteria
Staphylococcus hominis	Staphylococcus	Bacillota	Bacteria
Staphylococcus intermedius	Staphylococcus	Bacillota	Bacteria
Staphylococcus lugdunensis	Staphylococcus	Bacillota	Bacteria
Staphylococcus pettenkoferi	Staphylococcus	Bacillota	Bacteria
Staphylococcus pseudintermedius	Staphylococcus	Bacillota	Bacteria
Staphylococcus saccharolyticus	Staphylococcus	Bacillota	Bacteria
Staphylococcus saprophyticus	Staphylococcus	Bacillota	Bacteria
Staphylococcus schleiferi	Staphylococcus	Bacillota	Bacteria
Staphylococcus sciuri			
Staphylococcus simulans	Staphylococcus	Bacillota	Bacteria
Staphylococcus warneri	Staphylococcus	Bacillota	Bacteria
Stenotrophomonas maltophilia	Stenotrophomonas	Pseudomonadota	Bacteria
Streptobacillus felis	Streptobacillus	Fusobacteriota	Bacteria
Streptobacillus moniliformis	Streptobacillus	Fusobacteriota	Bacteria
Streptococcus	Streptococcus	Bacillota	Bacteria
Streptococcus agalactiae	Streptococcus	Bacillota	Bacteria
Streptococcus anginosus	Streptococcus	Bacillota	Bacteria
Streptococcus canis	Streptococcus	Bacillota	Bacteria
Streptococcus constellatus	Streptococcus	Bacillota	Bacteria
Streptococcus dysgalactiae	Streptococcus	Bacillota	Bacteria
Streptococcus equi	Streptococcus	Bacillota	Bacteria
Streptococcus equinus	Streptococcus	Bacillota	Bacteria
Streptococcus gallolyticus	Streptococcus	Bacillota	Bacteria
Streptococcus halichoeri	Streptococcus	Bacillota	Bacteria
Streptococcus iniae	Streptococcus	Bacillota	Bacteria
Streptococcus milleri	Streptococcus	Bacillota	Bacteria
Streptococcus pneumoniae	Streptococcus	Bacillota	Bacteria
Streptococcus pyogenes	Streptococcus	Bacillota	Bacteria
Streptococcus suis	Streptococcus	Bacillota	Bacteria
Streptococcus zooepidemicus			
Sutterella stercoralis			
Tannerella forsythia	Tannerella	Bacteroidota	Bacteria
Tenacibaculum	Tenacibaculum	Bacteroidota	Bacteria
Tenacibaculum maritimum	Tenacibaculum	Bacteroidota	Bacteria
Terrisporobacter glycolicus	Terrisporobacter	Bacillota	Bacteria
Terrisporobacter mayombei	Terrisporobacter	Bacillota	Bacteria
Treponema pallidum	Treponema	Spirochaetota	Bacteria
Treponema paraluis-cuniculi			
Trueperella abortisuis	Trueperella	Actinomycetota	Bacteria
Trueperella bernardiae	Trueperella	Actinomycetota	Bacteria
Trueperella pyogenes	Trueperella	Actinomycetota	Bacteria
Ureaplasma	Ureaplasma	Mycoplasmatota	Bacteria
Ureaplasma canigenitalium	Ureaplasma	Mycoplasmatota	Bacteria
Ureaplasma parvum	Ureaplasma	Mycoplasmatota	Bacteria
Ureaplasma urealyticum	Ureaplasma	Mycoplasmatota	Bacteria
Vagococcus	Vagococcus	Bacillota	Bacteria
Veillonella dispar	Veillonella	Bacillota	Bacteria
Vibrio	Vibrio	Pseudomonadota	Bacteria
Vibrio chitinovora			
Vibrio cholerae	Vibrio	Pseudomonadota	Bacteria
Wolbachia pipientis	Wolbachia	Pseudomonadota	Bacteria
Bacillus anthracis	Bacillus	Bacillota	Bacteria
Bacillus piliformis	Tyzzerella	Bacillota	Bacteria
Coxiella	Coxiella	Mollusca	Eukaryota
Coxiella burnetii	Coxiella	Pseudomonadota	Bacteria
Edwardsiella ictaluri	Edwardsiella	Pseudomonadota	Bacteria
Lawsonia intracellularis	Lawsonia	Thermodesulfobacteriota	Bacteria
Morganella	Morganella	Arthropoda	Eukaryota
Morganella morganii	Morganella	Pseudomonadota	Bacteria
Paracoccus yeei	Paracoccus	Pseudomonadota	Bacteria
Proteus	Proteus	Chordata	Eukaryota
Proteus mirabilis	Proteus	Pseudomonadota	Bacteria
Proteus vulgaris	Proteus	Pseudomonadota	Bacteria
Rothia kristinae	Rothia	Actinomycetota	Bacteria
Rothia mucilaginosa	Rothia	Actinomycetota	Bacteria
Rothia nasimurium	Rothia	Actinomycetota	Bacteria
Serratia	Serratia	Arthropoda	Eukaryota
Serratia marcescens	Serratia	Pseudomonadota	Bacteria
Yersinia	Yersinia	Arthropoda	Eukaryota
Yersinia enterocolitica	Yersinia	Pseudomonadota	Bacteria
Yersinia pestis	Yersinia	Pseudomonadota	Bacteria
